000 000 000 000 000 000 003 000 000 000 000 000 000 000 000 000 000 000 000 000 000 003 000 000 000 000 000 000 000 000 000 000 000 000 000 000 000 000 000 006
006 000 000 000 000 000 003 000 000 000 000 000 000 000 000 000 000 000 000 000 000 003 000 000 000 000 000 000 006 000 000 000 000 000 000 000 000 000 000 000
000 000 000 000 000 000 003 000 000 009 010 000 000 000 000 000 000 000 000 000 000 003 000 000 000 000 000 000 000 000 000 005 000 000 000 000 000 000 000 000
000 004 000 000 000 000 003 000 000 011 012 000 000 000 000 000 000 006 000 000 000 003 000 000 000 000 000 000 000 000 000 000 000 000 000 000 000 000 004 000
000 000 000 000 000 000 003 000 000 000 000 000 000 000 000 000 000 000 000 000 000 003 000 000 000 000 000 000 000 000 000 000 000 000 000 000 000 000 000 000
000 000 000 000 000 000 003 003 003 003 000 000 000 000 000 000 000 000 000 004 000 003 000 000 000 000 000 000 000 000 000 000 000 000 000 005 000 000 000 000
000 000 000 000 000 000 000 000 000 003 000 000 000 000 000 000 000 000 000 000 000 003 003 003 003 003 003 003 003 003 000 000 000 000 000 000 000 000 000 000
000 000 005 000 000 000 000 000 000 003 000 000 000 000 000 000 005 000 000 003 003 003 000 000 000 000 000 000 000 003 000 000 000 000 000 000 000 000 000 000
000 000 000 000 004 000 000 000 000 003 000 000 000 000 000 000 000 000 000 003 000 000 000 000 000 000 000 000 000 003 000 000 000 000 000 000 000 000 000 000
000 000 000 000 000 000 000 000 000 003 003 003 003 003 003 003 000 000 000 003 000 006 000 000 000 000 000 000 000 003 000 000 000 000 000 000 000 000 000 000
000 000 000 000 000 000 000 000 000 000 004 000 000 000 000 003 000 000 000 003 000 000 000 000 000 000 000 000 000 003 003 003 003 000 000 000 000 006 000 000
000 000 007 007 007 007 007 007 000 000 000 000 000 000 000 003 003 003 003 003 000 000 000 000 000 000 000 000 000 000 000 000 003 000 000 000 000 000 000 000
000 000 007 007 007 007 007 007 000 000 000 000 000 000 000 000 000 000 000 000 000 000 000 000 000 000 000 000 000 000 000 000 003 000 000 000 000 000 000 000
000 000 007 007 007 007 007 007 000 000 000 000 000 000 000 000 000 000 000 000 000 005 000 000 000 000 000 000 004 000 000 000 003 006 000 000 000 000 000 000
000 000 000 000 000 000 000 000 000 000 000 000 000 000 000 000 000 000 000 005 000 000 000 000 000 000 000 000 000 000 000 000 003 000 000 000 000 000 000 000
000 000 000 000 000 000 000 000 000 005 000 000 000 000 006 000 000 000 000 000 000 000 000 000 000 000 000 000 000 000 000 000 003 000 000 000 000 000 000 000